"variable","level","count"
"age","66",1
"age","69",1
"age","61",2
"age","64",2
"age","67",2
"age","68",2
"age","70",2
"age","12",3
"age","13",3
"age","15",3
"age","60",3
"age","65",3
"age","17",4
"age","56",5
"age","58",5
"age","62",5
